1111111111111111111
10000001000001P0001
1011101101100111001
100C100C00100000001
1011111111100011111
1000000000000010001
1010011000111110E01
10C0011000111110001
1010000000010000001
1010111111010011111
100000C001000000C01
1111111111111111111