


F                         220,100,255


NO                   ./textures/north.xpm






EA          ./textures/east.xpm



WE                           ./textures/west.xpm



SO          ./textures/south.xpm





C                                         50,80,60





        1111111111111111111111111
        1000000000110000000000001
        1011000001110000000000001
        1001000000000000000000001
111111111011000001110000000000001
100000000011000001110111111111111
11110111111111011100000000001
11110111111111011101010000001
11000000110101011100000000001
10000000000000001100000010001
10000000000000001101010010001
11000001110101011111011110N0111
11110111 1110101 101111010001
11111111 1111111 111111111111
1         101               1
1          1         0      1
11111111111111111111111111111











