1111111111
1C000000C1
1011111101
1010E0P001
1011111101
1C000000C1
1111111111