1111111111
10000000C1
1P0000C011
1C000000E1
1111111111